################################
#                              #
# ############# ################
#                              #
#   #### ###############       #
#      # #                     #
#      # ###############       #
#                              #
################################
